###############################
#     #     #     #     #     #
#  S        #     #           #
#     #     #     #     #     #
### ##### ##### ##### ##### ###
#     #     #     #     #     #
#     #                       #
#     #     #     #     #     #
### ##### ################# ###
#     #     #     #     #     #
#     #     #        E        #
#     #     #     #     #     #
###############################
